+--+--+--+--+--+
|           *  |
+  +--+--+  +  +
|  |     |     *
+  +--+  +--+  +
|     |     |  *
+              +
|              *
+              +
|             g|
+--+--+--+--+--+
